NO ./tiles/1.xpm
SO ./tiles/2.xpm
WE ./tiles/3.xpm
EA ./tiles/4.xpm

F 128,128,128
C 153,204,255

1111111111111111111111111111111111111111111111111111111111
1000000000000000000000000000110000000000000000000000000001
1000000000000000000000000000110000000000000000000000000001
1000000000000000000000000000110000000000000000000000000001
1000000000000000000000000000000000000000000000000000000001
1000000000000000000000000000110000000000000000000000000001
1000000000000000000000000000110000000000000000000000000001
1000000000000000000000000000110000000000000000000000000001
1000000000000000000000000000110000000000000000000000000001
1000000000000000000000000000110000000000000000000000000001
1000000000000000000000000000110000000000000000000000000001
1000000000000000000000N00000110000000000000000000000000001
1111111111111111111111111111111111111111111111111111110001
1000000000000000000000000000110000000000000000000000000001
1000000000000000000000000000110000000000000000000000000001
1000000000000000000000000000110000011111000000000000000001
1000000000000000000000000000110000000001000000000000000001
1000000000000000000000000000111111111001000000000000000001
1000000000000000000000000000000000000001000000000000000001
1000000000000000000000000000111111111111000000000000000001
1000000000000000000000000000110000000000000000000000000001
1000000000000000000000000000110000000000000000000000000001
1000000000000000000000000000110000000000000000000000000001
1111111111111111111111111111111111111111111111111111111111