NO ./tiles/1_1024.xpm
SO ./tiles/2_1024.xpm
WE ./tiles/3_1024.xpm
EA ./tiles/4_1024.xpm

F 128,128,128
C 153,204,255

11111111111111111111111111111111111111111
10000000000000000000000001000000000000001
10000000000000000000000001000000000000001
10000000000000000000000001111111000000001
1000000000000000000000000D000001000000001
10000000000000000000000001111001000000001
1000000000000000D000000001111001000000001
10000000000000000000000001111000000000001
10000000000000000000000001111111000000001
10000000000000000000000001111111000000001
11111111D11111111111111111111111000000001
1E000000011111111111111111111111111011111
10000000000111111111111111111111000000001
1111111111D111111111111111111111000000001
11111111100000100000000001111111011111111
11111111100000100000000001111111011111111
11111111100000100000000001111111000000001
11111111100000100000000001111111000000001
11111111111111100000000000000000000000001
11111111111111111111111111111111111111111