NO ./tiles/1_256.xpm
SO ./tiles/2_256.xpm
WE ./tiles/3_256.xpm
EA ./tiles/4_256.xpm

F 128,128,128
C 153,204,255

11111111111111111111111111111111111111111
10000000000000000000000001000000000000001
10000000000000000000000001000000000000001
10000000000000000000000001111111000000001
10000000000000000000000000000001000000001
10000000000000000000000001111001000000001
10000000000000000000000001111001000000001
10000000000000000000000001111000000000001
10000000000000000000000001111111000000001
10000000000000000000000001111111000000001
11111111D11111111111111111111111000000001
1E000000011111111111111111111111111011111
10000000000111111111111111111111000000001
11111111110111111111111111111111000000001
11111111100000100000000001111111011111111
11111111100000100000000001111111011111111
11111111100000100000000001111111000000001
11111111100000100000000001111111000000001
11111111111111100000000000000000000000001
11111111111111111111111111111111111111111