NO ./tiles/1.xpm
SO ./tiles/2.xpm
WE ./tiles/3.xpm
EA ./tiles/4.xpm

F 128,128,128
C 153,204,255

11111111111111111111111111111111111111111
10000000000000000000000001000000000000001
10000000000000000000000001000000000000001
10000000000000000000000001111111000000001
10000000000000000000000000000001000000001
10000000000000000000000001111001000000001
100000000000000N0000000001111001000000001
10000000000000000000000001111000000000001
10000000000000000000000001111111000000001
10000000000000000000000001111111000000001
11111111011111111111111111111111000000001
10000000011111111111111111111111111011111
10000000000111111111111111111111000000001
11111111110111111111111111111111000000001
11111111100000100000000001111111011111111
11111111100000100000000001111111011111111
11111111100000100000000001111111000000001
11111111100000100000000001111111000000001
11111111111111100000000000000000000000001
11111111111111111111111111111111111111111