NO ./tiles/1_256.xpm
SO ./tiles/2_256.xpm
WE ./tiles/3_256.xpm
EA ./tiles/4_256.xpm

F 128,128,128
C 153,204,255

11111111111111111111111111111111111111111
10000000000000000000000001000000000000001
1000000000000000000000000D000000000000001
10000000000000000000000001111111000000001
1000000000000000000000000000000D000000001
10000000000000000000000001111001000000001
100000000000000N0000000001111001000000001
10000000000000000000000001111000000000001
10000000000000000000000001111111000000001
10000000000000000000000001111111000000001
1111D111011111111111111111111111000000001
10000000011111111111111111111111111D11111
10000000000111111111111111111111000000001
1111111111D111111111111111111111000000001
11111111100000100000000001111111D11111111
11111111100000100000000001111111011111111
11111111100000D00000000001111111000000001
11111111100000100000000001111111000000001
1111111111111110000000000D00000D000000001
11111111111111111111111111111111111111111